	
Alder buckthorn	Rhamnus frangula
All-saints cherry	Prunus fruticosa
Allspice	Calycanthus fertilis
Almond cherry	Prunus glandulosa
Almond tree	Prunus dulcis
Almond-leaved willow	Salix triandra
Alpine currant	Ribes alpinum
Alpine elder	Sambucus racemosa
Alpine honeysuckle	Lonicera alpigena
Alpine laburnum	Laburnum alpinum
Alpine willow	Salix glabra
Alternate-leaf dogwood	Cornus alternifolia
Amber tree	Liquidambar formosana
American alder	Sambucus canadensis
American beech	Fagus grandifolia
American elderberry	Sambucus canadensis
American green alder	Alnus viridis ssp. Crispa
American hazel	Corylus americana
American holly	Ilex opaca
American hornbeam	Ostrya virginiana
American lime	Tilia americana
American linden	Tilia americana
American mountain ash	Sorbus americana
American olive	Osmanthus americanus
American persimmon	Diospyros virginiana
American red gum	Liquidambar styraciflua
American sweet gum	Liquidambar styraciflua
American white oak	Quercus lyrata
Amur cork tree	Phellodendron amurense
Amur linden	Tilia amurensis
Amur maackia	Maackia amurensis
Andormeda	Andromeda
Angelica tree	Aralia spinosa
Anise magnolia	Magnolia salifolia
Anise tree	Illicium
Antarctic beech	Nothofagus antarctica
Apple	Malus
Apple-leaved willow	Salix hastata
Aralia	Aralia
Armenian oak	Quercus pontica
Aromatic wintergreen	Gaultheria
Aron's beard	Cotinus coggygria
Arve	Pinus cembra
Ash	Fraxinus
Ash-leaved maple	Acer negundo
Aspen	Populus tremula
Atsuki pear	Sorbus alnifolia
Aucuba	Aucuba
Autumn cherry	Prunus subhirtella 'Autumnalis'
Azara	Azara
Azores holly	Ilex perado
Baccharis	Baccharis
Balearic box	Buxus balearica
Balkan maple	Acer hyrcanum
Ballota	Ballota
Balsam poplar	Populus balsamifera
Barbary wolfberry	Lycium barbarum
Barberry	Berberis
Barren privet	Rhamnus alaternus
Basket osier	Salix viminalis
Basket willow	Salix viminalis
Basswood	Tilia americana
Bastard box	Polygala chamaebuxus
Bastard chestnut	Liquidambar formosana
Bastard service tree	Sorbus thuringiaca
Baumann's horse chestnut	Aesculus hippocastanum 'Baumannii
Bay laurel	Laurus nobilis
Bay willow	Salix pentandra
Bay-leaved willow	Salix pentandra
Bayberry	Myrica
Bead tree	Melia azedarach
Beam tree	Sorbus torminalis
Bear oak	Quercus ilicifolia
Bearberry	Arctostaphylos
Beauty berry	Callicarpa
Beauty bush	Kolkwitzia Amabilis
Beech	Fagus
Bell heather	Erica cinerea
Benjamin tree	Lindera benzoin
Bentham's cornel	Cornus capitata
Big leaf linden	Tilia platyphyllos
Big leaf storax	Styrax obassia
Billberry	Vaccinium
Bilsted	Liquidambar styraciflua
Birch	Betula
Bird cherry	Prunus padus
Bird of paradise	Caesalpinia gilliesii
Bitter nut	Carya cordiformis
Bitter nut hickory	Carya cordiformis
Black alder	Alnus glutinosa
Black beech	Nothofagus solandri
Black birch	Betula lenta
Black crow berry	Empetrum nigrum
Black gum	Nyssa sylvatica
Black jack oak	Quercus marilandica
Black jetbead	Rhodotypos scandens
Black locust	Robinia pseudo-acacia
Black mulberry, common mulberry	Morus nigra
Black oak	Quercus velutina
Black poplar	Populus nigra
Black walnut	Juglans nigra
Blackberry	Rubus fruticosus
Blackthorn	Prunus spinosa
Bladdernut	Staphylea
Blood currant	Ribes sanguineum
Blood-twig cornel	Cornus Sanguinea
Blue beech	Carpinus caroliniana
Blue honeysuckle	Lonicera caerulea
Blue mountain heath	Phyllodoce caerulea
Blue oak	Quercus douglasii
Bluebeard	Caryopteris
Bluebeart	Caryopteris incana
Blueberry	Vaccinium
Blueberry willow	Salix nigricans
Bog bilberry	Vaccinium uliginosum
Bog heather	Erica tetralix
Bog rosemary	Andromeda polifolia
Bog whortleberry	Vaccinium uliginosum
Bog willow	Salix myrtilloides
Bony berry	Osteomeles
Bottle brush	Callistemon citrinus
Bottle-brush buckeye	Aesculus parviflora
Bowwood	Maclura pomifera
Box elder	Acer negundo
Box thorn	Lycium
Box tree	Buxus
Box-leaf azara	Azara microphylla
Bramble	Rubus fruticosus
Brasiletto	Caesalpinia
Bristlecone pine	Pinus aristata
Broad-leaved lime	Tilia platyphyllos
Broad-leaved maple	Acer macrophyllum
Broad-leaved spindle tree	Euonymus latifolius
Broom	Cytisus
Buckeye	Aesculus
Buckthorn	Rhamnus
Buffalo currant	Ribes odoratum
Bull bay	Magnolia grandiflora
Burr oak	Quercus macrocarpa
Bush cinquefoi	Potentilla fruticosa
Bush groundsel	Baccharis Halimifolia
Bush honey-suckle	Diervilla
Butterfly bush	Buddleja
Butternut	Juglans cinerea
Buttonbush	Cephalanthus occidentalis
Cabbage tree	Cordyline Australis
Calico bush	Kalmia latifolia
California bay	Umbellularia californica
Californian allspice	Calycanthus occidentalis
Californian black oak	Quercus kelloggii
Californian laurel	Umbellularia californica
Californian lilac	Ceanothus arboreus
Californian pepper tree	Schinus molle
Californian privet	Ligustrum ovalifolium
Callistemon	Callistemon
Camellia	Camellia
Camperdown elm	Ulmus glabra 'Camperdownii
Camphor tree	Cinnamomum camphora
Canadian maple	Acer rubrum
Canadian yellow birch	Betula alleghaniensis
Canary holly	Ilex perado
Canoe birch	Betula papyrifera
Cappadocian maple	Acer cappadocicum
Carob	Ceratonia siliqua
Carob tree	Ceratonia
Carolina horse chestnut	Aesculus neglecta
Carolina silverbell	Halesia carolina
Cassinia	Cassinia
Catalpa	Catalpa
Caucasian ivy	Hedera colchica
Caucasian oak	Quercus macranthera
Caucasina elm	Zelkova carpinifolia
Caucasina laurel	Prunus laurocerasus 'Causica
Caucasina wing nut	Pterocarya fraxinifolia
Ceanothus	Ceanothus
Cess apple	Sorbus aria
Chaste tree	Vitex
Chennar tree	Platanus orientalis
Chequer tree	Sorbus torminalis
Cherry birch	Betula lenta
Cherry plum	Prunus cerasifera
Cherry woodbine	Lonicera alpigena
Chestnus oak	Lithocarpus densiflorus
Chestnut	Castanea
Chestnut oak	Quercus petraea
Chestnut-leaved oak	Quercus castaneifolia
Chile eucryphia	Eucryphia glutinosa
Chilean firebush	Embothrium coccineum
Chinaberry	Melia azedarach
Chinese angelica tree	Aralia chinensis
Chinese aralia	Aralia chinensis
Chinese ash	Fraxinus chinensis
Chinese beech	Fagus engleriana
Chinese birch	Betula chinensis
Chinese buckthorn	Rhamnus utilis
Chinese bush cherry	Prunus glandulosa
Chinese cedar	Toona sinensis
Chinese chestnut	Castanea mollissima
Chinese elm	Ulmus parvifolia
Chinese flowering ash	Fraxinus sieboldiana
Chinese hackberry	Celtis sinensis
Chinese hazel	Corylus chinensis
Chinese horse chestnut	Aesculus chinensis
Chinese lilac	Syringa chinensis
Chinese mahonia	Mahonia fortunei
Chinese persimmon	Diospyros kaki
Chinese pistachio	Pistasia chinensis
Chinese poplar	Populus lasiocarpa
Chinese prinsepia	Prinsepia sinensis
Chinese privet	Ligustrum sinense
Chinese red-barked birch	Betula albosinensis
Chinese redbud	Cercis chinensis
Chinese sassafras	Sassafras tzumu
Chinese sumach	Rhus potaninii
Chinese tea	Camellia sinensis
Chinese toon	Toona sinensis
Chinese tulp tree	Liriodendron chinense
Chinese varnish tree	Koelreuteria paniculata
Chinese windmill palm	Trachycarpus fortunei
Chinese wing nut	Pterocarya stenoptera
Chinese wolfberry	Licium chinense
Choke cherry	Prunus virginiana
Chokeberry	Aronia
Christ's thorn	Paliurus spina-christi
Chusan palm	Trachycarpus fortunei
Cider gum	Eucalyptus gunnii
Ciliated heath	Erica ciliaris
Cinnamon	Cinnamomum
Cinquefoil	Potentilla
Clammy locust	Robinia viscosa
Clove currant	Ribes odoratum
Cobnut	Corylus Avellana
Coffee tree	Gymnocladus
Colchis ivy	Hedera colchica
Colg√ºe	Nothofagus dombeyi
Common alder	Alnus glutinosa
Common almond	Prunus dulcis
Common ash	Fraxinus excelsior
Common barberry	Berberis vulgaris
Common bearberry	Arctostaphylos uva-ursi
Common beech, european beech	Fagus sylvatica
Common box	Buxus sempervirens
Common broom	Cytisus scoparius
Common camellia	Camellia japonica
Common catalpa	Catalpa bignonioides
Common choke cherry	Prunus virginiana
Common dogwood	Cornus sanguinea
Common dwarf willow	Salix repens
Common elder	Sambucus nigra
Common elm	Ulmus minor
Common fig	Ficus carica
Common heather	Calluna vulgaris
Common holly	Ilex aquifolium
Common hop tree	Ptelea trifoliata
Common hornbeam	Carpinus betulus
Common horse chestnut	Aesculus hippocastanum
Common laburnum	Laburnum anagyroides
Common lavender	Lavandula angustifolia
Common lilac	Syringa vulgaris
Common linden	Tilia cordata
Common myrtle	Myrtus communis
Common oak	Quercus robur
Common olive	Olea europaea
Common osier	Salix viminalis
Common pawpaw	Asimina triloba
Common privet	Ligustrum vulgare
Common quince	Cydonia oblonga
Common sallow	Salix caprea
Common sassafras	Sassafras albidum
Common silver birch	Betula pendula
Common tea	Camellia sinensis
Common walnut	Juglans regia
Common white birch	Betula pubescens
Common wild medlar	Mespilus germanica
Common witch hazel	Hamamelis virginiana
Common woad-waxen	Genista tinctoria
Commun oleander	Nerium oleander
Connemera heath	Daboecia cantabrica
Coral bark maple	Acer palmatum 'Corallinum
Coral bark willow	Salix alba 'Chermesina'
Coral bush	Erythrina crista-galli
Coral tree	Erythrina
Coralberry	Symphoricarpus orbiculatus
Coriaria	Coriaria
Cork oak	Quercus suber
Cork tree	Phellodendron
Corkscrew hazel	Corylus Avellana 'Contorta
Cornelian cherry	Cornus Mas
Cornish heath	Erica vagans
Correa	Correa
Cotton gum	Nyssa aquatica
Cow berry	Vaccinium vitis-idaea
Cranberry	Vaccinium oxycoccus
Cranesbill	Geranium
Crape myrtle	Lagerstroemia
Creeping willow	Salix repens
Cretan maple	Acer sempervirens
Crinodendron	Crinodendron
Cristal tea ledum	Ledum palustre
Cross-leaved heath	Erica tetralix
Crowberry	Empetrum nigrum
Crown vetch	Coronilla
Cucumber tree	Magnolia acuminata
Currant	Ribes
Cypress oak	Quercus robur 'Fastigiata
Dahoon	Ilex cassine
Daimio oak	Quercus dentata
Daimyo oak	Quercus dentata
Daisybush	Olearia
Damson	Prunus spinosa
Dane's elder	Sambucus ebulus
Daphne	Daphne
Daphne willow	Salix daphnoides
Dark-leaved willow	Salix nigricans
Date plum	Diospyros lotus
Davidia	Davidia
Deciduous stewartia	Stewartia pseudocamellia
Deep-veined maple	Acer argutum
Delavay's magnolia	Magnolia delavayi
Dense head mountain ash	Sorbus alnifolia
Deutzia	Deutzia
Devil wood	Osmanthus americanus
Devil's club	Oplopanax horridus
Devil's walkingstick	Aralia spinosa
Dewberry	Rubus caesius
Dipteronia	Dipteronia
Dogwood	Cornus
Dombey's southern beech	Nothofagus dombeyi
Dorset heath	Erica ciliaris
Double furze	Ulex europaus
Double gean	Prunus avium 'Plena
Douglas spirea	Spiraea douglasii
Dove tree	Davidia involucrata
Downy birch	Betula pubescens
Downy japanese maple	Acer japonicum
Downy oak	Quercus pubescens
Dracena	Cordyline
Dragon's claw willow	Salix matsudana 'Tortuosa
Drimys	Drimys
Duck oak	Quercus nigra
Dukke of argyll's tea tree	Licium chinense
Durmast oak	Quercus petraea
Dutch elm	Ulmus hollandica
Dwarf american cherry	Prunus pumila
Dwarf birch	Betula nana
Dwarf cherry	Prunus fruticosa
Dwarf fan palm	Chamaerops humilis
Dwarf furze	Ulex minor
Dwarf gorse	Ulex minor
Dwarf maple	Acer glabrum
Dwarf russian almond	Prunus tenella
Dwarf willow	Salix herbacea
Dyer's greenweed	Genista tinctoria
Dyer's oak	Quercus velutina
Eared sallow	Salix aurita
Eastern hop hornbeam	Ostrya virginiana
Eastern hornbeam	Carpinus orientalis
Eastern redbud	Cercis canadensis
Edging box	Buxus sempervirens cv. 'Suffruticosa
Elaeagnus	Elaeagnus
Elaeagnus willow	Salix elaeagnos
Elder	Sambucus
Elm	Ulmus
Elm zelkova	Zelkova carpinifolia
English holly	Ilex aquifolium
English oak	Quercus robur
English walnut	Juglans regia
Erdbeere	Fragaria ananassa
Erman's birch	Betula ermanii
Eucalyptus	Eucalyptus
Eucommia	Eucommia
Eucryphia	Eucryphia
European alder	Alnus incana
European ash	Fraxinus excelsior
European aspen	Populus tremula
European bird cherry	Prunus padus
European bladdernut	Staphylea pinnata
European cranberry bush	Viburnum opulus
European dewberry	Rubus caesius
European elder	Sambucus nigra
European fan palm	Chamaerops humilis
European golden ball	Forsythia europaea
European hazel	Corylus Avellana
European hop hornbeam	Ostrya carpinifolia
European hornbeam	Carpinus betulus
European mountain ash	Sorbus aucuparia
European privet	Ligustrum vulgare
European red elder	Sambucus racemosa
European turkey oak	Quercus cerris
European white birch	Betula pendula
European white lime	Tilia tomentosa
Evergreen buckthorn	Rhamnus alaternus
Evergreen magnolia	Magnolia grandiflora
Evergreen oak	Quercus ilex
Exochorda	Exochorda
False acacia	Robinia pseudo-acacia
False beech	Nothofagus
False indigo	Amorpha fruticosa
False spirea	Sorbaria
False tamarisk	Myricaria
Fan berry	Vaccinium oxycoccus
Fan palm	Chamaerops
Farges catalpa	Catalpa fargesii
February daphne	Daphne mezereum
Fever bush	Lindera benzoin
Field elm	Ulmus minor
Field maple, hedge maple	Acer campestre
Fig tree	Ficus carica
Filbert	Corylus avellana
Finnish whitebeam	Sorbus hybrida
Fir	Abies
Fire bush	Embothrium
Fire thorn	Pyracantha
Five stamen tamarisk	Tamarix tetrandra
Flag honeysuckle	Lonicera xylosteum
Flowering ash	Fraxinus ornus
Flowering currant	Ribes sanguineum
Flowering dogwood	Cornus florida
Flowering plum	Prunus triloba
Fly honeysuckle	Lonicera xylosteum
Folgner's whitebeam	Sorbus folgneri
Fontainebleau service tree	Sorbus latifolia
Fontanesia	Fontanesia
Formosan sweet gum	Liquidambar formosana
Forsythia	Forsythia intermedia
Foxtail pine	Pinus balfouriana
Fragrant thimbleberry	Rubus odoratus
French lavender	Lavandula stoechas
French maple	Acer monspessulanum
French sumac	Coriaria myrtifolia
French willow	Salix triandra
Fringe tree	Chionanthus virginicus
Fringed heath	Erica ciliaris
Fuchsia	Fuchsia
Fullmoon maple	Acer japonicum
Furze	Ulex
Garland flower	Daphne cneorum
Gentian	Gentiana
German broom	Genista germanica
German tamarisk	Myricaria germanica
German woad-waxen	Genista germanica
Germander spirea	Spiraea chamaedryfolia
Ghost tree	Davidia involucrata
Giant dogwood	Cornus controversa
Giant filbert	Corylus maxima
Glabrous willow	Salix glabra
Glory bower	Clerodendrum
Glory pea	Clianthus Puniceus
Glory tree	Clerodendrum
Glossy buckthorn	Rhamnus frangula
Glossy privet	Ligustrum lucidum
Goat willow	Salix caprea
Gold ash	Fraxinus excelsior 'Jaspidea'
Gold rain tree	Koelreuteria
Golden chain	Laburnum
Golden chain laburnum	Laburnum anagyroides
Golden hardhack	Potentilla fruticosa
Golden heather	Cassinia fulvida
Golden rain	Laburnum anagyroides
Golden sycomore	Acer pseudoplatanus 'Worleyi
Goldenrain tree	Koelreuteria paniculata
Gorse	Ulex europaus
Grape elder	Sambucus racemosa
Great cob	Corylus maxima
Great sallow	Salix caprea
Grecian laurel	Laurus nobilis
Gree osier	Cornus alternifolia
Green alder	Alnus viridis
Green broom	Genista tinctoria
Grey alder	Alnus incana
Grey birch	Betula populifolia
Grey sallow	Salix cinerea
Grey snake-bark maple	Acer rufinerve
Grey-budded snake-bark maple	Acer rufinerve
Groundcherry	Prunus fruticosa
Groundsel	Senecio
Guelder rose	Viburnum opulus
Gum cistus	Cistus ladanifer
Gum tree	Eucalyptus
Gutta-percha tree	Eucommia ulmoides
Hackberry	Celtis occidentalis
Hagberry	Prunus padus
Hairy genista	Genista pilosa
Hairy greenweed	Genista pilosa
Halberd- leaved willow	Salix hastata
Halimium	Halimium
Hardy catalpa	Catalpa speciosa
Hardy rubber tree	Eucommia ulmoides
Harry lauder's walking stick	Corylus avellana 'Contorta'
Hawthorn maple	Acer crataegifolium
Hawthorn-leaved maple	Acer crataegifolium
Hazel	Corylus avellana
Headache tree	Umbellularia californica
Heath	Erica
Heather	Calluna
Hebe	Hebe
Hedge apple	Maclura pomifera
Hedgehog holly	Ilex aquifolium 'Ferox'
Heldreich's maple	Acer heldreichii
Hemp tree	Vitex agnus-castus
Hercules club	Aralia spinosa
Hickory	Carya
Highbushblueberry	Vaccinium corymbosum
Highclere holly	Ilex altaclerensis
Himalayan birch	Betula utilis
Hoary willow	Salix elaeagnos
Hogweed	Cytisus scoparius
Holly	Ilex
Holly oak	Quercus ilex
Holly tree	Ilex aquifolium
Holly-leaved cherry	Prunus ilicifolia
Holm oak	Quercus ilex
Honey locust	Gleditsia triacanthos
Honeysuckle	Lonicera
Hop hornbeam	Ostrya
Hop tree	Ptelea trifoliata
Hornbeam	Carpinus
Hornbeam ash	Sorbus alnifolia
Hornbeam maple	Acer carpinifolium
Horse chestnut	Aesculus
Hungairian oak	Quercus frainetto
Hungarian lilac	Syringa josikaea
Hungarian silver lime	Tilia tomentosa
Hupeh rowan	Sorbus hupehensis
Hybrid catalpa	Catalpa erubescens 'Purpurea'
Hydrangea	Hydrangea
Idesia	Idesia
Indian bean tree	Catalpa bignonioides
Indian currant	Symphoricarpus orbiculatus
Indian horse chestnus	Aesculus indica
Indigo plant	Indigofera
Irish heath	Daboecia
Iron tree	Parrotia persica
Ironwood	Ostrya virginiana
Italian alder	Alnus cordata
Italian buckthorn	Rhamnus alaternus
Italian maple	Acer opalus
Italian oak	Quercus frainetto
Ivy	Hedera
Japanes apricot	Prunus mume
Japanese angelica tree	Aralia elata
Japanese anis tree	Illicium anisatum
Japanese aucuba	Aucuba japonica
Japanese beech	Fagus japonica
Japanese big-leaved magnolia	Magnolia hypoleuca
Japanese big-leaved oak	Quercus aliena
Japanese bitter orange	Poncirus trifoliata
Japanese cherry	Prunus serrulata
Japanese chestnut-leaved oak	Quercus acutissima
Japanese crab	Malus floribunda
Japanese euonymus	Euonymus japonicus
Japanese evergreen oak	Quercus acuta
Japanese flowering crab apple	Malus floribunda
Japanese golddust tree	Aucuba japonica
Japanese hornbeam	Carpinus japonica
Japanese horse chestnut	Aesculus turbinata
Japanese katsura tree	Cercidiphyllum japonicum
Japanese kerria	Kerria japonica
Japanese mahonia	Mahonia japonica
Japanese maple	Acer palmatum
Japanese medlar	Eriobotrya japonica
Japanese pagoda tree	Sophora japonica
Japanese pepper	Zanthoxylum piperitum
Japanese privet	Ligustrum japonicum
Japanese raisin tree	Hovenia dulcis
Japanese rowan	Sorbus commixta
Japanese snowball	Viburnum plicatum
Japanese stewartia	Stewartia pseudocamellia
Japanese walnut	Juglans ailanthifolia
Japanese weeping pagoda tree	Sophora japonica 'Pendula'
Japanese white birch	Betula platyphylla var. japonica
Japanese white pine	Pinus parviflora
Japanese wing nut	Pterocarya rhoifolia
Japanese zelkova	Zelkova serrata
Jasmin box	Phillyrea latifolia
Jasmine	Jasminum
Jerusalem sage	Phlomis fruticosa
Jerusalem thorn	Paliurus spina-christi
Jessamine	Cestrum
Jetbead	Rhodotypos
Judas tree	Cercis siliquastrum
Jujube	Ziziphus jujuba
Kaki plum	Diospyros kaki
Kalmia	Kalmia
Kalopanax	Kalopanax
Kashmir rowan	Sorbus cashmiriana
Katsura tree	Cercidiphyllum
Keaki	Zelkova serrata
Kentucky coffee tree	Gymnocladus dioicus
Kermes oak	Quercus coccifera
Kerria	Kerria
Kidney-vetch	Anthyllis
Killarney strawberry tree	Arbutus unedo
King-nut	Carya laciniosa
Kobus magnolia	Magnolia kobus
Kolkwitzia	Kolkwitzia
Korean fir	Abies koreana
Korean maple	Acer pseudosieboldianum
Kousa dogwood	Cornus kousa
Kowhai	Sophora tetraptera
Labrador tea	Ledum groenlandicum
Laburnocytisus	Laburnocytisus
Laburnum	Laburnum
Lads's love	Artemisia abrotanum
Lambert nut	Corylus Maxima
Lambkill kalmia	Kalmia angustifolia
Large-flowered st. johns wort	Hypericum calycinum
Large-leaved cucumber tree	Magnolia macrophylla
Large-leaved lime	Tilia platyphyllos
Large-leaved magnolia	Magnolia macrophylla
Laurel	Laurus
Laurel willow	Salix pentandra
Laurel-leaved rock rose	Cistus laurifolius
Laurestinus viburnum	Viburnum tinus
Laurustine	Viburnum tinus
Laurustinus	Viburnum tinus
Lavender	Lavandula
Lavender willow	Salix elaeagnos
Lead plant	Amorpha canescens
Least willow	Salix herbacea
Lebanon oak	Quercus libani
Ledum	Ledum
Lilac	Syringa
Lily magnolia	Magnolia liliiflora
Lily of the vlley tree	Clethra arborea
Lime tree	Tilia
Lime-leaved maple	Acer distylum
Linden	Tilia
Ling	Calluna vulgaris
Lion's ear	Leonotis leonurus
Lion's-ear	Leonotis
Little shellbark hickory	Carya ovata
Little tree willow	Salix arbuscula
Little-leaf linden	Tilia cordata
Lobster's claw	Clianthus puniceus
Locust	Robinia
Locust tree	Ceratonia siliqua
London plane	Platanus hispanica
Loquat	Eriobotrya
Lucombe oak	Quercus hispanica 'Lucombeana'
Ludwig's oak	Quercus ludoviciana
Macckia	Maackia
Macedonian oak	Quercus trojana
Madeira holly	Ilex perado
Madrone	Arbutus
Magellan fuchsia	Fuchsia magellanica
Magnolia	Magnolia
Mahonia	Mahonia
Mallow	Hibiscus syriacus
Manchurian cherry	Prunus maackii
Manchurian lime	Tilia mandshurica
Manchurian linden	Tilia mandshurica
Manchurian maple	Acer mandshuricum
Manchurian walnut	Juglans mandshurica
Manna ash	Fraxinus ornus
Manzanita	Arctostaphylos
Maple	Acer
Maritime pine	Pinus pinaster
Marsh ledum	Ledum palustre
Marsh rosemary	Andromeda polifolia
Mastic tree	Schinus molle
Maximowicz maple	Acer maximowiczianum
Mealy guleder rose	Viburnum lantana
Medic	Medicago
Mediterranean buckthorn	Rhamnus alaternus
Mediterranean herb elder	Sambucus ebulus
Medlar	Mespilus germanica
Melaleuca	Melaleuca
Mexican orange blossom	Choisya ternata
Mezereon	Daphne mezereum
Mezereon willow	Salix daphnoides
Milkwort	Polygala chamaebuxus
Miyabe's maple	Acer miyabei
Mock orange	Philadelphus coronarius
Mock privet	Phillyrea
Monarch birch	Betula maximowicziana
Mongolian birch	Betula davurica
Mongolian lime	Tilia mongolica
Mongolian linden	Tilia mongolica
Mongolian oak	Quercus mongolica
Monks pepper	Vitex agnus-castus
Montpellier maple	Acer monspessulanum
Moon trefoil	Medicago arborea
Moorwort	Rosmarinus officinalis
Moosberry	Vaccinium oxycoccus
Moose bark maple	Acer pensylvanicum
Moosewood	Acer pensylvanicum
Mop head acacia	Robinia pseudo-acacia 'Umbraculifera'
Mossy-cup oak	Quercus macrocarpa
Mount etna broom	Genista aetnensis
Mountain ash	Sorbus aucuparia
Mountain cranberry	Vaccinium vitis-idaea
Mountain currant	Ribes alpinum
Mountain heath	Phyllodoce
Mountain laurel	Kalmia latifolia
Mountain maple	Acer spicatum
Mountain peony	Paeonia suffruticosa
Mountain snowdrop tree	Halesia monticola
Mountain trefoil	Medicago arborea
Mulberry	Morus
Myrobolan plum	Prunus cerasifera
Myrtle	Lagerstroemia indica
Myrtle coriaria	Coriaria myrtifolia
Myrtle tree	Nothofagus cunnighamii
Myrtle-leaved willow	Salix myrtilloides
Nandina	Nandina
Nannyberry	Viburnum lentago
Narrow-leaved ash	Fraxinus angustifolia
Narrow-leaved vetch	Phillyrea angustifoli
Needle furze	Genista anglica
Needle woad-waxen	Genista anglica
Nettle tree	Celtis australis
Nettle tree, sugarberry	Celtis
New zealand christmas tree	Metrosideros excelsa
New zealand sophora	Sophora tetraptera
Nine bark	Physocarpus opulifolius
Nirre	Nothofagus antartica
North american hackberry	Celtis occidentalis
Northern catalpa	Catalpa speciosa
Northern japanese magnolia	Magnolia kobus
Northern red oak	Quercus rubra
Norway maple	Acer platanoides
Norway spruce	Picea abies
Nuttall's dogwood	Cornus nuttallii
Nwe zealand pittosporum	Pittosporum tenuifolium
Nyman's eurcryphia	Eucryphia nymansensis
Oak	Quercus
Oak-leaved mountain ash	Sorbus hybrida
Officinal storax	Styrax officinalis
Ohio buckeye	Aesculus glabra
Old english lavender	Lavandula angustifolia
Old english poplar	Populus nigra
Old-man wormwood	Artemisia abrotanum
Oleander	Nerium
Oleaster	Elaeagnus angustifolia
Olive tree	Olea
Olive tree-leaved spurge	Daphne oleoides
Oliver's lime	Tilia oliveri
Oliver's linden	Tilia oliveri
One-leaved ash	Fraxinus excelsior 'Diversifolia'
Opalus maple	Acer opalus
Orange ball tree	Buddleja globosa
Orange blossom	Choisya
Oregon ash	Fraxinus latifolia
Oregon grape	Mahonia aquifolium
Oregon maple	Acer macrophyllum
Oregon myrtle	Umbellularia californica
Oriental cherry	Prunus serrulata
Oriental hornbeam	Carpinus orientalis
Oriental liquidambar	Liquidambar orientalis
Oriental plane	Platanus orientalis
Oriental sweet gum	Liquidambar orientalis
Osage orange	Maclura
Osier	Salix
Osmanthus	Osmanthus
Oval-leaf privet	Ligustrum ovalifolium
Overcup oak	Quercus lyrata
Oyama magnolia	Magnolia sieboldii
P√®re david's maple	Acer davidii
Pacific dogwood	Cornus nuttallii
Pagoda dogwood	Cornus alternifolia
Pagoda tree	Sophora japonica
Painted mona maple	Acer mono
Pale sweet shrub	Calycanthus fertilis
Paliurus	Paliurus
Papaw	Asimina
Paper birch	Betula papyrifera
Paper mulberry	Broussonetia papyrifera
Paperbark maple	Acer griseum
Parasol acacia	Robinia pseudo-acacia 'Umbraculifera'
Parrot's bill	Clianthus puniceus
Parrotbeak	Clianthus
Parrotia	Parrotia
Pawpaw	Asimina triloba
Pea shrub	Caragana
Pea tree	Caragna arborescens
Peach	Prunus persica
Pear	Pyrus
Pecan nut	Carya illinoinensis
Peking willow	Salix matsudana
Pendunculate oak	Quercus robur
Peony	Paeonia
Pepper tree	Schinus molle
Pepperidge	Nyssa sylvatica
Pepperidge bush	Berberis vulgaris
Perny's holly	Ilex pernyi
Persian acacia	Albizia julibrissin
Persian ironwood	Parrotia persica
Persian ivy	Hedera colchica
Persian lilac	Syringa persica
Persian oak	Quercus macranthera
Persian parrotia	Parrotia persica
Persian walnut	Juglans regia
Persimmon	Diospyros virginiana
Petty whin	Genista anglica
Phillyrea	Phillyrea latifolia
Pieris	Pieris
Pin oak	Quercus palustris
Pine	Pinus
Pink siris	Albizia julibrissin
Pinyon pine	Pinus cembroides
Pistache	Pistacia
Pittosporum	Pittosporum
Plane	Platanus
Plane tree	Platanus hispanica
Plum	Prunus
Pocket-handkerchief tree	Davidia involucrata
Pomegrenate	Punica granatum
Poncirus	Poncirus
Pontic oak	Quercus pontica
Poplar	Populus
Poplar-leaved rock rose	Cistus populifolius
Portuguese laurel	Prunus lusitanica
Post oak	Quercus stellata
Prickly ash	Zanthoxylum
Pride of india	Koelreuteria paniculata
Prinsepia	Prinsepia
Privet	Ligustrum
Provence broom	Cytisus purgans
Pubescent birch	Betula pubescens
Pubescent oak	Quercus pubescens
Punica	Punica
Purge broom	Cytisus purgans
Purging thorn	Hippophae rhamnoides
Purple ash	Fraxinus Angustifolia 'Raywood'
Purple japanese maple	Acer palmatum 'Atropurpureum'
Purple osier	Salix purpurea
Purple willow	Salix purpurea
Purple-flowering raspberry	Rubus odoratus
Purple-leaved barberry	Berberis vulgaris 'Atropurpurea'
Purple-leaved birch	Betula pendula 'Purpurea'
Purple-leaved sand cherry	Prunus cistena
Purpre sycamore	Acer pseudoplatanus 'Atropurpureum'
Pussy willow	Salix caprea
Pyrenean oak	Quercus pyrenaica
Queen's grape myrtle	Lagerstroemia indica
Quercitron oak	Quercus velutina
Quickbeam	Sorbus aucuparia
Quince	Cydonia
Ragwort	Senecio
Raisin tree	Hovenia
Raoul beech	Nothofagus procera
Rauli	Nothofagus procera
Red ash	Fraxinus pennsylvanica
Red bearberry	Arctostaphylos uva-ursi
Red bilberry	Vaccinium vitis-idaea
Red buckeye	Aesculus pavia
Red chokeberry	Aronia arbutifolia
Red horse chestnut	Aesculus carnea
Red maple	Acer rubrum
Red mulberry	Morus rubra
Red oak	Quercus rubra
Red snake-bark maple	Acer capillipes
Red whortleberry	Vaccinium uliginosum
Red willow	Salix purpurea
Red-barked dogwood	Cornus Alba
Red-berried elder	Sambucus racemosa
Redbud	Cercis
River birch	Betula nigra
Roble	Nothofagus obliqua
Roble pellin	Nothofagus obliqua
Rockrose	Cistus
Rocky mountain maple	Acer glabrum
Rose	Rosa
Rose acacia	Robinia hispida
Rose bay	Nerium oleander
Rose of sharon	Hibiscus syriacus
Rosemary	Rosmarinus
Rouen lilac	Syringa chinensis
Rough-barked maple	Acer triflorum
Round-ear willow	Salix aurita
Rowan	Sorbus aucuparia
Rumanian oak	Quercus macranthera
Russian olive	Elaeagnus angustifolia
Sacred bamboo	Nandina domestica
Sage	Salvia
Sage-brush	Artemisia
Sage-leaved rock rose	Cistus salvifolius
Sallow thorn	Hippophae rhamnoides
Salt tree	Halimodendron halodendron
Saltbush, orache	Atriplex
Sand cherry	Prunus pumila
Sargent's cjherry	Prunus sargentii
Sargent's rowan	Sorbus sargentiana
Sassafras	Sassafras
Sauces magnolia	Magnolia soulangeana
Scarlet maple	Acer rubrum
Scarlet oak	Quercus coccinea
Scarlet willow	Salix alba 'Chermesina'
Scorpion senna	Coronilla emerus
Scotch broom	Cytisus scoparius
Scotch heath	Erica cinerea
Scotch heather	Calluna vulgaris
Scotch laburnum	Laburnum alpinum
Scotch pine	Pinus sylvestris
Sea buckthorn	Hippophae rhamnoides
Senna	Cassia
Service tree	Sorbus domestica
Service tree mountain ash	Sorbus domestica
Serviceberry, juneberry	Amelanchier spicata
Sessile oak	Quercus petraea
Shagbark hickory	Carya ovata
Sharp-leaved willow	Salix acutifolia
Sheep laurel	Kalmia latifolia
Sheep-berry	Viburnum lentago
Shellbark hickory	Carya laciniosa
Shingle oak	Quercus imbricaria
Shiny-leaved yellow-horn	Xanthoceras sorbifolium
Shrubberies	Staphylea pinnata
Shrubby althea	Hibiscus syriacus
Shrubby birch	Betula humilis
Shrubby cinquefoil	Potentilla fruticosa
Shrubby horehound	Ballota
Shrubby treefoil	Ptelea trifoliata
Shrubby trefoil	Jasminum fruticans
Shumard red oak	Quercus shumardii
Siberian crab	Malus baccata
Siberian salt tree	Halimodendron halodendron
Siebold maple	Acer sieboldianum
Silk tree	Albizia julibrissin
Silk-tassel tree	Garrya
Silky broom	Genista pilosa
Silver bell	Halesia monticola
Silver berry	Elaeagnus communata
Silver birch	Betula pendula
Silver heather	Cassinia vauvilliersii Albida
Silver lime	Tilia tomentosa
Silver linden	Tilia tomentosa
Silver maple	Acer saccharinum
Silver poplar	Populus alba 'Nivea'
Silverleaf magnolia	Magnolia hypoleuca
Simmondsia	Jojoba
Single-leaf pinyon	Pinus monophylla
Sinleaf yellow-horn	Xanthoceras sorbifolium
Sloe	Prunus spinosa
Sloe bush	Prunus spinosa
Small cranberry	Vaccinium oxycoccus
Small-flowered rock rose	Cistus parviflorus
Small-leaved lime	Tilia cordata
Smoke tree	Cotinus coggygria
Smooth japanese maple	Acer palmatum
Smooth sumac	Rhus glabra
Smooth-leaved elm	Ulmus minor
Snake-bark maple	Acer grosseri
Snow gum	Eucalyptus niphophila
Snow wreath	Neviusia
Snowball	Viburnum
Snowbell tree	Styrax japonicus
Snowberry	Symphoricarpus
Snowdrop tree	Halesia
Sorrel tree	Oxydendrum arboreum
Sour cherry	Prunus cerasus
Sour tree	Oxydendrum arboreum
Sourwood	Oxydendrum
Southern ash	Fraxinus angustifolia
Southern catalpa	Catalpa bignonioides
Southern magnolia	Magnolia grandiflora
Southern nettle tree	Celtis australis
Southern poplar	Populus balsamifera
Southernwood	Artemisia abrotanum
Spanish box	Buxus balearica
Spanish broom	Spartium junceum
Spanish chestnut	Castanea sativa
Spanish oak	Quercus hispanica
Spanish's broom	Spartium
Speckled alder	Alnus incana
Spice bush	Lindera
Spike broom	Cytisus nigricans
Spike lavender	Lavandula angustifolia
Spike winter hazel	Corylopsis spicata
Spindle tree	Euonymus
Spiny furze	Genista germanica
Spirea	Spiraea
Spur leaf	Tetracentron sinense
Spurge laurel	Daphne laureola
St. antony's nut	Staphylea pinnata
St. daboec's heath	Daboecia cantabrica
St. john's bread	Ceratonia
St. john's wort	Hypericum
Stag's horn sumach	Rhus typhina
Staghorn	Rhus typhina
Star anise	Illicium anisatum
Star magnolia	Magnolia stellata
Stewartia	Stewartia
Stinking ash	Ptelea trifoliata
Storax	Styrax
Strawberry	Fragaria ananassa
Strawberry tree	Arbutus unedo
Striped maple	Acer pensylvanicum
	
Tartarian cornel	Coriaria myrtifolia
Tasmanian myrtle	Nothofagus cunnighamii
Tatarian honeysuckle	Lonicera tatarica
Tatarian maple	Acer tataricum
Tea plant	Camellia sinensis
Tetracentron	Tetracentron
Texan walnut	Juglans microcarpa
Thornless honey locust	Gleditsia triacanthos 'Sunburst'
Thuringe hybrid ash	Sorbus thuringiaca
Tibetan cherry	Prunus serrula
Tick clover	Desmodium
Tick-trefoil	Desmodium elegans
Toon	Toona
Transcaucasian birch	Betula medwediewii
Tree alfalfa	Medicago arborea
Tree heath	Erica arborea
Tree ivy	Hedera helix 'Arborescens'
Tree medic	Medicago arborea
Tree of heaven	Ailanthus altissima
Tree peony	Paeonia suffruticosa
Tree privet	Ligustrum lucidum
Tree purslane	Atriplex halimus
Trembling aspen	Populus tremula
Trident maple	Acer buergerianum
Trifoliate orange	Poncirus trifoliata
True bay	Laurus nobilis
True lavender	Lavandula angustifolia
True myrtle	Myrtus communis
True service tree	Sorbus domestica
Tulip tree	Liriodendron
Tupelo	Nyssa
Turkey oak	Quercus cerris
Turki	Corylus maxima
Turkish filbert	Corylus colurna
Turkish hazel	Corylus colurna
Turner's oak	Quercus turneri
Tutsan	Hypericum androsaemum
Twisted heath	Erica cinerea
Umbellularia	Umbellularia
Umbrella tree	Magnolia tripetala
Van volxem's maple	Acer velutinum vanvolxemii
Veitch's hybrid magnolia	Magnolia veitchii
Venetian sumach	Cotinus coggygria
Vilmorin's rowan	Sorbus vilmorinii
Vine maple	Acer circinatum
Vine-leaved maple	Acer cissifolium
Violet	Viola
Violet willow	Salix daphnoides
Virginia sweet spires	Itea virginica
Virginia willow	Itea virginica
Virginian witch hazel	Hamamelis virginiana
Voss's laburnum	Laburnum watereri 'Vossii'
Walnut	Juglans
Warminster broom	Cytisus praecox
Warted spindle tree	Euonymus verrucosus
Water birch	Betula occidentalis
Water elder	Viburnum opulus
Water oak	Quercus nigra
Water tupelo	Nyssa aquatica
